偉大:小勞勃·道尼   Robert Downey Jr.	「鋼鐵人」東尼·史塔克 Iron Man / Tony Stark
盡力了:克里斯·伊凡   Chris Evans	「美國隊長」史蒂芬·羅傑斯 Captain America / Steve Rogers
就一弟弟:克里斯·漢斯沃   Chris Hemsworth	索爾 Thor
有幫上忙的:馬克·盧法洛   Mark Ruffalo	「綠巨人浩克」布魯斯·班納 Hulk / Bruce Banner
偉大:史嘉蕾·喬韓森   Scarlett Johansson	「黑寡婦」娜塔莎·羅曼諾夫 Black Widow / Natasha Romanoff
有幫上忙的:傑瑞米·雷納   Jeremy Renner	「鷹眼／浪人」克林特·巴頓 Hawkeye / Ronin / Clint Barton
有幫上忙的:凱倫·吉蘭   Karen Gillan	涅布拉 Nebula
有幫上忙的:保羅·路德   Paul Rudd	「蟻人」史考特·朗恩 Ant-Man / Scott Lang
盡力了:唐·奇鐸   Don Cheadle	「戰爭機器」詹姆士·「羅德」·羅德斯 War Machine / James "Rhodey" Rhodes
有幫上忙的:布萊德利·庫柏   Bradley Cooper	火箭浣熊 Rocket Raccoon
超神:布麗·拉森   Brie Larson	「驚奇隊長」卡蘿·丹佛斯 Captain Marvel / Carol Danvers
有幫上忙的:葛妮絲·派特洛   Gwyneth Paltrow	維吉妮雅·「小辣椒」·波茲 Virginia "Pepper" Potts
盡力了:達娜·古瑞拉   Danai Gurira	奧科耶 Okoye
有幫上忙的:泰莎·湯普森    Tessa Thompson	瓦爾基麗 Valkyrie
打醬油的:強·法夫洛   Jon Favreau	哈羅德·「快樂」·霍根 Harold "Happy" Hogan
打醬油的:黃凱旋   Benedict Wong	王 Wong
打醬油的:溫斯頓·杜克   Winston Duke	恩巴庫 M'Baku
打醬油的:塔伊加·維迪提    Taika Waititi	寇格 Korg
很厲害:班奈狄克·康柏拜區   Benedict Cumberbatch	「奇異博士」史蒂芬·史傳奇 Doctor Strange / Stephen Strange
有幫上忙的:查德威克·鮑斯曼   Chadwick Boseman	「黑豹」帝查拉 Black Panther / T'Challa
有幫上忙的:湯姆·霍蘭德   Tom Holland	「蜘蛛人」彼得·帕克 Spider-Man / Peter Parker
超神:伊莉莎白·歐森   Elizabeth Olsen	「緋紅女巫」汪達·馬克希莫夫 Scarlet Witch / Wanda Maximoff
有幫上忙的:安東尼·麥基   Anthony Mackie	「獵鷹」山姆·威爾森 Falcon / Sam Wilson
有幫上忙的:賽巴斯汀·斯坦   Sebastian Stan	「酷寒戰士」巴奇·巴恩斯 Winter Soldier / Bucky Barnes
有幫上忙的:克里斯·普瑞特   Chris Pratt	「星爵」彼得·奎爾 Star-Lord / Peter Quill
有幫上忙的:戴夫·巴帝斯塔   Dave Bautista	「毀滅者」德克斯 Drax the Destroyer
有幫上忙的:龐·克萊門捷夫   Pom Klementieff	螳螂女 Mantis
有幫上忙的:馮·迪索   Vin Diesel	格魯特 Groot
打醬油的:伊凡潔琳·莉莉   Evangeline Lilly	「黃蜂女」荷普·汎戴茵 Wasp / Hope van Dyne
打醬油的:莉蒂西亞·萊特   Letitia Wright	舒莉 Shuri
關鍵人物:麥克·道格拉斯   Michael Douglas	漢克·皮姆 Hank Pym
打醬油的:蜜雪兒·菲佛   Michelle Pfeiffer	珍妮特·汎戴茵 Janet van Dyne
幕後黑手:山繆·傑克森    Samuel L. Jackson	尼克·福瑞 Nick Fury
打醬油的:蔻碧·史莫德   Cobie Smulders	瑪莉亞·希爾 Maria Hill
英雄的家人:琳達·卡德里尼   Linda Cardellini	蘿拉·巴頓 Laura Barton
英雄的家人:艾娃·羅素   Ava Russo	萊拉·巴頓 Lila Barton
英雄的家人:雅各布·貝塔隆   Jacob Batalon	奈德·利茲 Ned Leeds
演員:湯姆·希德斯頓   Tom Hiddleston	洛基 Loki
有幫上忙的:柔伊·莎達娜   Zoe Saldana	葛摩菈 Gamora
黑幫成員:法蘭克·葛里洛   Frank Grillo	「交叉骨」布洛克·朗姆洛 Crossbones / Brock Rumlow
關鍵人物:蒂妲·史雲頓   Tilda Swinton	古一 The Ancient One
英雄的家人:蕾妮·羅素   Rene Russo	芙瑞嘉 Frigga
黑幫成員:勞勃·瑞福   Robert Redford	亞歷山大·皮爾斯 Alexander Pierce
打醬油的:海莉·艾特沃   Hayley Atwell	佩姬·卡特 Peggy Carter
英雄的家人:約翰·斯拉特里   John Slattery	霍華·史塔克 Howard Stark
黑幫成員:麥斯希姆諾·赫南德茲   Maximiliano Hernandez	賈斯伯·西德維爾 Jasper Sitwell
boss:喬許·布洛林   Josh Brolin	薩諾斯 Thanos
垃圾:泰瑞·諾特利   Terry Notary	黑曜獵手 Cull Obsidian
垃圾:湯姆·沃恩-羅勒   Tom Vaughan-Lawlor	烏木喉 Ebony Maw
垃圾:麥可·詹姆士·蕭   Michael James Shaw	亡刃 Corvus Glaive
垃圾:凱莉·庫恩   Carrie Coon	暗夜比鄰星   Proxima Midnight
復仇者的家人:艾瑪·福爾曼   Emma Fuhrmann	凱西·朗恩 Cassie Lang   
復仇者的家人:瑪麗莎·托梅   Marisa Tomei	梅·帕克  May Parker
復仇者的家人:亞歷山德拉·拉貝   Alexandra Rabe	摩根·史塔克 Morgan Stark 
復仇者的家人:安琪拉·貝瑟   Angela Bassett	拉瑪達 Ramonda 
路過:凱瑞·康頓   Kerry Condon	「星期五」 F.R.I.D.A.Y 
路過:詹姆士·達西   James D'Arcy	艾德恩·賈維斯 Edwin Jarvis
路過:真田廣之   Hiroyuki Sanada	昭彥 Akihiko
路過:羅斯·馬奎德   Ross Marquand	「紅骷髏」約翰·施密特 Red Skull / Johann Schmidt
路過:威廉·赫特   William Hurt	撒迪厄斯·E·「雷霆」·羅斯 Thaddeus E."Thunderbolt" Ross
路過:卡爾·穆爾維   Callan Mulvey	傑克·羅林斯 Jack Rollins
路過:泰·辛普金斯   Ty Simpkins	哈利·奇納 Harley Keener
路過:鄭肯   Ken Jeong	保全 Security guard
路過:伊薇特·尼科爾·布朗恩   Yvette Nicole Brown	神盾局特工 S.H.I.E.L.D. agent
路過:史丹·李   Stan Lee	1970年代駕駛 1970s car driver

